wwwwwwwwwwwwwwwwwwwww
w-------------------w
w-------------------w
w---------G---------w
w-------------------w
wb------------------w
wwwwwwwwwwwwwwwwwwwww