wwwwwww
w--b--w
w-----w
w--d--w
w-----w
w-----w
w--G--w
wwwwwww
